Walk : [W/A/S/D]=Laufen: [W/A/S/D]
Start game : [E]=Spiel Starten : [E]
Grab : [E]=Nehmen : [E]
Scan : [RMB]=Scannen : [RMB]
Sprint: [Shift]=Sprinten : [E]
Open : [E]=Öffnen : [E]
Open : [E]=Öffnen : [E]
Switch camera : [E]=Kamera Wechseln : [E]
Turn on/off : [E]=An/Aus : [E]
Access terminal : [E]=Terminal Öffnen : [E]
Quit terminal : [TAB]=Terminal Schließen : [TAB]
Open door : [E]=Tür Öffnen : [E]
Close door : [E]=Tür Schließen : [E]
[Nothing to store]=[Nichts Zum Einlagern]
Enter: [E]=Betreten : [E]
Enter : [E]=Betreten : [E]
Exit : [E]=Verlassen : [E]
Store item : [E]=Gegenstand Einlagern : [E]
Use door : [E]=Tür Benutzen : [E]
Start ship : [E]=Los Fliegen : [E]
Land ship : [E]=Schiff Landen : [E]
Flip switch: [E]=Schalter Umlegen : [E]
Switch lights : [E]=Lichtschalter Umlegen : [E]
Pull cord: [E] (Hold)=Signal Abgeben : [E] (Halten)
Climb : [E]=Klettern : [E]
Let go : [E]=Loslassen : [E]
Use ladder : [E]=Leiter Benutzen : [E]
Hit pumpkin : [E]=Kürbis Schlagen : [E]
Play record: [E]=Platte Abspielen : [E]
Switch water: [E]=Wasser Benutzen : [E]
Sell item : [E]=Gegenstand Verkaufen : [E]
Charge item : [E]=Gegenstand Aufladen : [E]
Flush: [E]=Spülen : [E]
Disable speaker: [E]=Lautsprecher Ausschalten : [E]
Switch TV: [E]=Fernseher Umschalten : [E]
Lift glass : [E]Deckel Öffnen : [E]
Beam up : [E]=Teleportieren: [E]
Confirm: [B]   |   Rotate: [R]   |   Store: [X]=Bestätigen [B]  |   Rotieren: [R]  |   Einlagern: [X]
Pull valve : [E]=Ventil Drehen: [E]
Change: Green suit=Anzug Wechseln: Grüner Anzug
